"a" = (/turf/wall,/area)
"b" = (/turf/floor,/area)

(1,1,1) = {"
aaaaaaaaaaaaaaaaaaaa
abbbbbbbbbbbbbbbbbba
abbbbbbbbbbbbbbbbbba
abbbbbbbbbbbbbbbbbba
abbbbbbbbbbbbbbbbbba
abbbbbbbbbbbbbbbbbba
abbbbbbbbbbbbbbbbbba
abbbbbbbbbbbbbbbbbba
abbbbbbbbbbbbbbbbbba
abbbbbbbbbbbbbbbbbba
aaaaaaaaaaaaaaaaaaba
abbbbbbbbbbbbbbbbbba
abbbbbbbbbbbbbbbbbba
abbbbbbbbbbbbbbbbbba
abbbbbbbbbbbbbbbbbba
abbbbbbbbbbbbbbbbbba
abbbbbbbbbbbbbbbbbba
abbbbbbbbbbbbbbbbbba
abbbbbbbbbbbbbbbbbba
aaaaaaaaabbaaaaaaaaa
"}
